3,,,,,,,,,,,,,,,,,,,,,,,,,,,,,,,,,,,,,,,,,,,,,,,,,,,,,,,,,,,,,,,,,,,,,,,,,,,,,,,,,,,,,,,,,,,,,,,,,,,,,,,,,,,,,,,,,,,,,,,,,2,2,,,,,,,,,,,,,,,,,,,,,,,,,,,,,,,,,,,,3
3,,,,,,,,,,,,,,,,,,,,,,,,,,,,,,,,,,,,,,,,,,0,2,,,,,,,,,,,,,,,,,,,,,,,,,,,,,,,,,,,,1,1,1,1,1,1,1,1,1,1,1,1,1,1,1,1,1,1,1,1,1,1,4,,,,,,,,,,,,,,,,,,,,1,1,,400,,,,,,,,,,,,,,,,,,,,,,,,,,,,,,,,,,3
3,,,,,,,,,,,,,,,,,2,2,802,2,2,2,,,,,,,,,,,,,,,,,,,0,2,1,,,,,,,,,,,,,,,,,,,,,,,,,,,,,,,,,,,,1,1,,,,,,1,1,1,1,1,1,1,1,1,1,1,1,1,1,1,4,,,,,,,,,,,,,,,,,,,,1,1,,,,,,,,,,,,,,,,,,,400,,,,,,,,,,,,,,,,,3
3,,,,,,,,,,,,,,,2,,1,1,1,1,1,1101,,,,,,,,,,,,,,,,,2,,0,1,,,,,,,,,,,,,9,1902,802,2,,,,,,,,,,,,,,,,, , , ,,1,1,,,,,,,,,,1,1,1,1,1,1,1,1,1,1,1,4,,400,,,,,,,,,,,,,0,2,202,2,1902,1,1,2,802,2, , ,,,,,,,202,,,,,,202,2,1902,2,,,2,2,2,,,,,,,,,,3
3,,,,,,,,,,,,,2,,1,,0,1,1,1,1,1,2,,,,,,,,,,,,,,,,1,2,,,,,,,,,,,,,9,1907,8,1,1,1,16,,,,,,,,,,,,,,,, , ,400,,1,1,400,,,,,,,,,,,,1,1,1,1,1,1,1,1,4,800,,,,,,,,,9,2,2,0,2,15,1,1,1,1001,1,1,1,1,1,16,202,,,,,,,1001,,,,,,1,1,1,1001,,,1001,10006,1201,,,,,,,,,,3
3,,,,,,300,,,,,,,1,2,,,0,1,1,1,1,1,1,,,,,,,,700,,,,,,,,,1,,,2,,,,,,,,9,1907,8,1,1,1,1,1,1,16,,,,,,,,,,,,,,,,,,,1001,1,,,,,,,,,,,,,,1,1,1,1,1,1701,1,4,4,4,,0,4,4,,2,7,8,1,1,5,1,1,1,1801,1,1,1,1,1,1,1,1001,1001,5,,,,,,,,,,,,1,1,,,,,,901,,,,,,,,,,,3
3,,,,,,,,,,,,,,1,,2,2,901,1,1,1,1401,1,2,,,700,,,,2,2,,,700,,,,,,,15,1,,,,,,9,1907,8,1,1,1,1,1,1,1,1,1,16,,,,400,,,,,,,,,0,2,1902,2,,1,1,,,,,,,,,,,,,,0,0,1,1,1,1,1,1,1,901,0,0,0,4,,1,1,1,1,1,1,1,1,1,1,1,1,1,1,1,1,1,1,1,1,,,,,,,,,,,,1,,,,,,,,,,,,,,,,,,3
3,,,,,2,1902,2,1902,2,1902,2,1902,2,2,15,1,1,1,1,1,1,1,1,1,16,2,1902,2,1902,15,1,1,16,2,1902,2,1902,2,1902,2,15,1,1,2,2,1902,2,1907,8,1,1,1,1,1,1,1,1,1,1501,1,1,16,2,0,2,1902,2,2,1902,2,802,1902,2,15,1,1,1,5,1,1,2,2,802,2,2,2,2,2,2,2,2,2,2,2,2,2,2,2,2,2,2,0,1,0,0,0,4,,1,1,1,1,1,1,1,1,1,1,1,1,1,1,1,1,1,1,1,1,,,,,,,,,,,,,,,,,,,,,,,,,,,,,,3
3,,,,,1,1,1001,1,1,1,1,1,1,1,1,1,1301,1,1,1,1,1,1,1,1,1,1,1,1,1,1,1,1,1,1,1,1,1,1,1,1,1,1,1,1,1,1,1,1,1,1,1,1,1,1,1,1,1,1,1,1,1,1,5,1,1,1,1,1,1,1,1,1,1,1,1601,1,1,1,1,1,1,1,1,1,1,1,1,1,1,1,1,1,1,1,1,1,1,1,1,1,5,1,,0,0,4,,1,1,1,1,1,1,1,1,1,1,1,1,1,1,1,1,1,1,1,1,,,,,,,,,,,,,,,,,,,,,,,,,,,,,,3
3,,,,,1,1,1,1,1,1,1,1,1,1,1,1,1,1,1,1,1,1,1,1,1,1,1,1,1,1,1,1,1,1,1,1,1,1,1,1,1,1,1,1,1,1,1,1,1,1,1,1,1,1,1,1,1,1,1,1,1,1,1,1,1,1,1,1,1,1,1,1,1,1,1,1,1,1,1,1,1,1,1,1,1,1,1,1,1,1,1,1,1,1,1,1,1,1,1,1,1,1,1,,0,0,4,,1,1,1,1,1,1,1,1,1,1,1,1,1,1,1,1,1,1,1,1,,,,,,,,,,,,,,,,,,,,,,,,,,,,,,3
3,,,,,,,,,,,,,,,,,,,,,,,,,,,,,,,,,,,,,,,,,,,,,,,,,,,,,,,,,,,,,,,,,,,,,,,,,,,,,,,,,,,,,,,,,,,,,,,,,,,,,,,,,,,,,,,,,,,,,,,,,,,1,1,1,1,1,,,,,,,,,,,,,,,,,,,,,,,,,,,,,,,3
3,,,,,,,,,,,,,,,,,,,,,,,,,,,,,,,,,,,,,,,,,,,,,,,,,,,,,,,,,,,,,,,,,,,,,,,,,,,,,,,,,,,,,,,,,,,,,,,,,,,,,,,,,,,,,,,,,,,,,,,,,,,,,,,,,,,,,,,,,,,,,,,,,,,,,,,,,,,,,,3
3,,,,,,,,,,,,,,,,,,,,,,,,,,,,,,,,,,,,,,,,,,,,,,,,,,,,,,,,,,,,,,,,,,,,,,,,,,,,,,,,,,,,,,,,,,,,,,,,,,,,,,,,,,,,,,,,,,,,,,,,,,,,,,,,,,,,,,,,,,,,,,,,,,,,,,,,,,,,,,3
3,3,3,3,3,3,3,3,3,3,3,3,3,3,3,3,3,3,3,3,3,3,3,3,3,3,3,3,3,3,3,3,3,3,3,3,3,3,3,3,3,3,3,3,3,3,3,3,3,3,3,3,3,3,3,3,3,3,3,3,3,3,3,3,3,3,3,3,3,3,3,3,3,3,3,3,3,3,3,3,3,3,3,3,3,3,3,3,3,3,3,3,3,3,3,3,3,3,3,3,3,3,3,3,3,3,3,3,3,3,3,3,3,3,3,3,3,3,3,3,3,3,3,3,3,3,3,3,3,3,3,3,3,3,3,3,3,3,3,3,3,3,3,3,3,3,3,3,3,3,3,3,3,3,3,3,3,3,3