,,,,,,,,,,,,,,,,,,,,,,,,,,,,,,,,,,,,,,,,,,,,,,,,,,,,,,,,,,,,,,2,,,,,,,4,,,,,,,,,,,,,,,,,,3,,,,,,,
,,,,,,,,,,,,,,,,,,,,,,,,,,,,,,,,,,,,,,,,,,,,,,,,,,,,,,,,,,,,,,1,2,2,,,,,4,4,4,4,4,,,,,,,,,,,,,,3,,,,,,,
,,,,,,,,,,,,,,,,,,,,,,,,,,,,,,,,,,,,,,,,,,,,,,,,,,,,,,,,,,,,,,1,1,1,,,2,202,5,,,,4,4,4,,,,,,,,,,,,3,,,,,,,
,,,,,,,,,,,,,,,,,,,,,,,,,,,,,,,,,,,,,,,,,,,,,,,,,,,,,,,,,,,,,,,,1,,,1,1,5,,4,0,5,0,400,,,,,,,,,,,,3,,,,,,,
3,,,,,,,,,,,,,,,,,,,,,,,,,,,,,,,,,,,,,,700,209,2,,,,,,,,0,2,,,2,,,0,,2,2,,,,2,,1,4,4,4,4,4,,4,4,4,4,0,0,,,0,,,,,,,,3,,,,,,,
3,,,,,,,,,,,,,,,,,,,,,,,,,,,,,,,400,,,,,,209,7,8,1,,,,,,,0,2,1,,,1,,,2,,1,1,,,,1,2,2,,,,1,4,,4,0,,4,2,2,2,2,2,2,2,2,2,,,,3,,,,,,,
3,,,,,,,,,,,,400,,0,,,,,,,,,,,,,,,,,,,,700,209,7,8,1,1,1,,,,,,0,2,1,1,,,,,,1,,,,,,,1,1,1,,,,1,4,,,202,,4,1,1,1,1,1,1,1,1,1006,,,,3,,,,,,,
3,,,,,,,300,,,,,,9,202,12,,,09,202,2,,700,,9,802,,,,,,,,209,7,8,1,1,1,1,1,,,,0,0,2,1,1,1,,,,,,,,,,,,,,,1,,,,1,4,4,4,1,,4,1,1,1,1,1,,,,,,,,3,,,,,,,
3,0,0,0,0,202,2,202,2,202,2, ,7,8,1,11,10,07,08,1,1,14,202,7,8,1,202,2,,2,,202,7,8,1,1,1,1,1,1,1,,,400,0,2,1,1,1,1,,700,,,700,,700,,,700,,700,,,1,,400,,1,4,4,4,4,,4,1,1,,,,,,,,,,,3,,,,,,,
3,0,0,0,0,1,1,1,1,1,1,5,1,1,1,1,1,1,1,1,1,1,1,1,1,1,1,1,5,1,5,1,1,1,1,1,1,1,1,1,1,802,2,202,13,1,0,2,2,2,2,2,2,2,2,2,2,2,2,2,2,2,2,2,1,802,202,0,1,0,0,0,4,0,4,4,4,,,,,,,,,,,3,,,,,,,
3,,,,,,,,1,1,1,1,1,1,1,1,1,1,1,1,1,,,,1,1,1,1,1,1,1,1,1,1,1,1,1,1,1,1,1,1,1,1,1,1,5,1,1,1,1,1,1,1,1,1,1,1,1,1,1,1,1,1,1,1,1,5,1,2,202,2,2,2,4,1,0,,,,,,,,,,,3,,,,,,,
3,,,,,,,,,,,,,,,,,,,,,,,,,,,,,,,,,,,,,,,,,,,,,1,1,1,,,,0,,,,0,0,,0,0,0,,,,,,1,1,1,1,1,1,1,1,4,,,,,,,,,,,,,3,,,,,,,
3,,,,,,,,,,,,,,,,,,,,,,,,,,,,,,,,,,,,,,,,,,,,,,,,,,,,,,,,,,,,0,,,,,,,,,,,,,,,,,,,,,,,,,,,3,,,,,,,
3,3,3,3,3,3,3,3,3,3,3,3,3,3,3,3,3,3,3,3,3,3,3,3,3,3,3,3,3,3,3,3,3,3,3,3,3,3,3,3,3,3,3,3,3,3,3,3,3,3,3,3,3,3,3,3,3,3,3,3,3,3,3,3,3,3,3,3,3,3,3,3,3,3,3,3,3,3,3,3,3,3,3,3,3,3,3,3,,,,,,,